R 10000 10000

NO ./textures/greystone.xpm
SO ./textures/purplestone.xpm
WE ./textures/redbrick.xpm
EA ./textures/bluestone.xpm

S ./textures/grass.xpm
F 197,143,105
C 31,168,210

	1111111111111111111111111
	1000000000110000000000001
	1111100001110000002000001
		1001000000000000000011111
111111111011000001110000000000001
111100000011000001110111110111111
11110111111111011100000010001
11110111111111011101010010001
11000000110101011100000010001
10002000000000001100000010001
10000000000000001101010010001
11000001110101011111011110N0111
11110111 1110101 101111010001
11111111 1111111 111111111111
