R 800 480

NO ./textures/greystone.xpm
SO ./textures/purplestone.xpm
WE ./textures/redbrick.xpm
EA ./textures/bluestone.xpm

S ./textures/grass.xpm
F 184,113,39
C 51,198,227

    11111111111111111111111111111
    10000000001100000000000000001
    10110000011100000000000010001
    10010000000000000000000011111
11111000011100000000000010001
10000000001100000111011110001
11110111111111011102002010001
11110111111111011101012010001
11000000110101011100000010001
10222220000000001100000010001
10222220W00000001101010010001
11222220110101000000000000001
11110111110101000000000000001
10000000001100000100000010001
10000000000000001010000101001
10000000001000010001010001001
1000000000110100000000000000111
10000000000100000001010000001
11111111111111111111111111111
